NO ./textures/north_61.xpm
SO ./textures/south_61.xpm
WE ./textures/west_61.xpm
EA ./textures/east_61.xpm

F 85,107,47
C 30,144,255

111111111111111111111111
100000000000000000000001
100000000000000000000001
100000000000000000000001
100000111110000100010001
100000100010000100010001
100000100010000100010001
100000100010000100010001
101111111110000100010001
100000000000000000000001
100000000000000000000001
100000000000000000000001
100000000000000000000001
100000000000000000000001
100000000000000000000001
100000001000000000000001
111111111000000N00000001
110000000000000000000001
110000001000000000000001
110000001000000000000001
110000000000000000000001
110000001000000000000001
111111111000000000000001
111111111111111111111111
