NO ./textures/negi-ramen.xpm
SO ./textures/iekei-ramen.xpm
WE ./textures/abura-soba.xpm
EA ./textures/kinmedai-ramen.xpm

F 102,205,170
C 105,105,105

111111111111111111111111
100000000000000000000001
100000000000000000000001
100000000000000000000001
100000222220000303030001
100000200020000000000001
100000200020000300030001
100000200020000000000001
100000220220000303030001
100000000000000000000001
100000000000000000000001
100000000000000000000001
100000000000000000000001
100000000000000000000001
100000000000000000000001
100000000000000000000001
144444444000000000000001
140400004000000000000001
140000504000000000000001
140400004000N00000000001
140444444000000000000001
140000000000000000000001
144444444000000000000001
111111111111111111111111
